111111111111
1P0000000001
10000000C001
100000000001
100000000001
10M000000001
1000C0000001
100000C00001
10000E000001
111111111111