1111111111111
1C100000000C1
1010111101111
1000100M00001
1010110110101
1P10C1E01C1C1
1111111111111