1111111111
1CEP000001
1000000001
1000000001
1000000001
1000000001
1000000001
1000000001
1000000001
111111111