1111111100
1CEP000001
1000000001
1000000001
1000000001
1000000001
1000000001
1000000001
1000000001
1111111111