1111111111111
1C100000000C1
1010111101111
1000100000011
1010110101011
1P01C1E0101C1
1111111111111