1111111111111
11C10000000C1
1101011110111
1100010000001
1101011010101
1P01C1E0101C1
1111111111111