1111111111
1CP0000001
1000000001
1000000001
1000000001
1000000001
1000000001
1000000001
1000000001
1111111111