1111111111
1CEEP00001
1000000001
1000000001
1000000001
1000000001
1000000001
1000000001
1000000001
1111111111