1111111111
10EP000001
1000000001
1000000001
1000000001
1000000001
1000000001
1000000001
1000000001
1111111111