1111111111
1CEP000001
1000000001
1000000001
10000a0001
1000000001
1000000001
1000000001
1000000001
1111111111
