1111111111
1CEPP00001
1000000001
1000000001
1000000001
1000000001
1000000001
1000000001
1000000001
1111111111