1111111111111
1C100000000C1
1010111101111
1000100000001
1010110111101
1P10C1E0101C1
1111111111111