111111111111111111111111111111
1111111111110000000000000000E1
111111111111011111111111111111
10000000000001C0000000000000C1
100111111111111001111111111001
10000000C000000001000001C11001
111111111111111111001001011011
1C0000000000000011001001011011
100011111111110011001001011011
100000000000010011001001011011
111111111100010011001001011011
1P0000000000010C00000000000001
111111111111111111111111111111